###################
#        #        #
#O## ### # ### ##O#
#                 #
# ## # ##### # ## #
#    #   #   #    #
#### ###.#.### ####
#### #.......# ####
#### #.#####.# ####
.... ..#   #.# ....
#### #.#####.# ####
#### #.......# ####
#### #.#####.# ####
#        #        #
# ## ### # ### ## #
#O #     P     # O#
## # # ##### # # ##
#    #   #   #    #
# ######   ###### #
###################