###################
#   B    #    C   #
#O## ### # ### ##O#
#                 #
# ## # ##### # ## #
#    #   #   #    #
#### ###.#.### ####
#### #.......# ####
#### #.#####.# ####
.... ..#...#.# ....
#### #.#####.# ####
#### #.......# ####
#### #.#####.# ####
#        #        #
# ## ### # ### ## #
#O #     P     # O#
## # # ##### # # ##
#  R #   #   # D  #
# ######   ###### #
###################