##################
.    #       #   .
#### # ##### # ###
#O   B   #   C  O#
# #### # # # ### #
# #    # # #   # #
# # ## #   # ### #
#    #.......#   #
#### #.#####.# ###
#    #.#####.#   #
# ##  .#####.# ###
#  # #.......#   #
## # ##.###.## # #
##    P ### P    #
## #### ### #### #
.    #       #   .
## # # ##### # ###
#O # R   #   D #O#
# ## ### # ### # #
##################