####################
#                # #
# # ### # # #### # #
# #   #            #
#  #  # # ## # # # #
# #            #   #
# # # # # ## ### # #
#                # #
# # # # #  # # # # #
# #   # #  # #     #
# # # # #  # # # # #
#              #   #
# ### # # ## ### # #
# #                #
# # # ### ## # # # #
#                # #
### ## # ## ###### #
#        P         #
####################
